1111111111111111111111
1111111111111111111111
1111111111111111111111
1111111111111111111111
1111000000100010001111
1111000000101010101111
1111011111101010101111
2000010000001010101111
2000000000001010101111
1111000000001010101111
1111100000001010101111
1111000000001010101111
1111000000001010101111
1111000000001010101111
1111000000001010101111
1111000000001010101111
1111000000001010111111
1111100000001000111111
1111111111111111111111
1111111111111111111111
1111111111111111111111
1111111111111111111111