1111111111111111111111
1111111111111111111111
1111111111111111111111
1111111111111111111111
1111111111111111111111
1111111000000000111111
1111111000000000011111
1111100000000000000002
1111100000000000000002
1111100000000000011111
1111100000000000111111
1111100000011111111111
1111100000011111111111
1111100000011111111111
1111100000011111111111
1111100000011111111111
1111100000011111111111
1111130000011111111111
1111100000011111111111
1111100000011111111111
1111111111111111111111
1111111111111111111111