1111111111111111111111
1111111111111111111111
1111111111111111111111
1111111111111111111111
1111300000000000001111
1111000000000000001111
1111000000000000001111
1111000000000000001111
1111001111001111001111
1111001111001111001111
1111001100030011001111
1111001140000011001111
1111001111111111001111
1111001111111111001111
1111000000000000001111
1111000000000000001111
1111000000000000001111
1111000330000000001111
1111111111001111111111
1111111111001111111111
1111111111001111111111
1111111111221111111111