1111111111111111111111
1111111111111111111111
1111100000011111111111
1111100000011111111111
1111100000011111111111
1111100000000000211111
1111100000000000011111
1111100000011110011111
1111100000011110011111
1111100000011110011111
1111100000011110011111
1111100000011110011111
1111100000011110011111
1111100000011110011111
1111100000011110011111
1111100000011111111111
1111100000011111111111
1111111111111111111111
1111111111111111111111
1111111111111111111111
1111111111111111111111
1111111111111111111111