1111111111111111111111
1111111111111111111111
1111111111111111111111
1111111111111111111111
1111000000000000001111
1111000000000000001111
1111000000000000001111
1111000000000000001111
1111000000200000001111
1111000000000000001111
1111000000000000001111
1111000000000000001111
1111000000000000001111
1111000000000000001111
1111000000000000001111
1111000000000000001111
1111000000000000001111
1111000000000000001111
1111111111111111111111
1111111111111111111111
1111111111111111111111
1111111111111111111111