1111111111111111111111
1111111111111111111111
1111111111111111111111
1111111111111111111111
1111000003100010001111
1111000000101010101111
1111011111101010101111
1100010000001010101111
1100000000001010101111
1111000000001010101111
1111100000001010101111
1111000000001010101111
1111000000001010101111
1111000000001010101111
1111000000001010101111
1111000000001010101111
1111000000001010101111
1111100000001000121111
1111111111111111111111
1111111111111111111111
1111111111111111111111
1111111111111111111111