1111122222211111111111
1111100000011111111111
1111100000011111111111
1111100000011111111111
1111100000011111111111
1111100000000000011111
1111100000000000011111
1111100000011110011111
1111100000011110011111
1111100000011110011111
1111100000011110011111
1111100000011110011111
1111101111011110011111
1111101001011110011111
1111101001011110311111
1111101111011111111111
1111100000011111111111
1111111111111111111111
1111111111111111111111
1111111111111111111111
1111111111111111111111
1111111111111111111111