1111111111111111111111
1111111111111111111111
1111111111111111111111
1111111111111111111111
1111111111111111111111
1111100000000000111111
1111100000000000011111
1111100000000000000011
1111100000000000000011
1111100000000000011111
1111100000000000111111
1111100000011111111111
1111100000011111111111
1111100000011111111111
1111100000011111111111
1111100000011111111111
1111100000011111111111
1111100000011111111111
1111100000011111111111
1111100000011111111111
1111100000011111111111
1111122222211111111111