1111111111331111111111
1111111111001111111111
1111111111001111111111
1111111111001111111111
1111111111001111111111
1111111111011111111111
1111111111001111111111
1111111111001111111111
1111111111101111111111
1111111111001111111111
1111111111001111111111
1111111111001111111111
1111111111101111111111
1111111111001111111111
1111111111001111111111
1111111111011111111111
1111111111001111111111
1111111111101111111111
1111111111001111111111
1111111111001111111111
1111111111001111111111
1111111111221111111111