1111111111221111111111
1111111111001111111111
1111111111001111111111
1111111111001111111111
1111111111001111111111
1111111111001111111111
1111111111001111111111
1111111111001111111111
1111111100000011111111
1111111100000011111111
1111111100000011111111
1111111100000011111111
1111111100000011111111
1111111100000011111111
1111111111111111111111
1111111111111111111111
1111111111111111111111
1111111111111111111111
1111111111111111111111
1111111111111111111111
1111111111111111111111
1111111111111111111111